0000000000
0111111110
0000000000
0011001100
0010000100
0011001100
0000000000
0111111110
0000000000