0001100000
0100000010
0000001001
0000000000
0010000100
0000001100
0000000000
0110000100
0001000100