000000000000
001100000000
000000001100
000000000000
000100010000
000111110000
000000000000
001000000000
001000000000
000000000100
000000000010
000000000100