0000000000
0011000000
0000000010
0000000000
0001001000
0001111000
0000000000
0000000001
0000000010
1000000001